NO ./textures/red.xpm
SO ./textures/eagle.xpm
WE ./textures/greystone.xpm
EA ./textures/purplestone.xpm
F 220,100,0
C 225,30,0

111
101
111

    1111
    10N1
    1111
