NO ./textures/red.xpm
SO ./textures/eagle.xpm
WE ./textures/greystone.xpm
EA ./textures/purplestone.xpm

F 220,100,0
C 225,30,0

                  1
          1  1    11
        1111111111111111111111111
        10000000001100000000000011111
        1011000001110000001000001   111
        1001000000000000000000001    1
111111111011000001110000000000001    111111111111111
100000000011000001110111111111111
11110111111111011100000010001
11110111111111011101010000001
11000000110101011100000010001
10001000000000001100000010001
10000000000000001101010010001
1100000111010101111101111000111
11110111 1110101 101111010001
11111111 1111111 111111111111
